#
# 1 D room3.txt 0
# 0 D room1.txt 1
#
WWWWWWWWWW
WSm P  ggW
W gWW  WWW
W WWg   sW
W Wg  gW W
W  S  W  W
W    gW  W
W  WWW   W
0  W    RW
WWWW1WWWWW
