#
# 0 D room1.txt 0 Key0
#
WWWW0WWWWW
Wggg ggggW
WgB     gW
WWWWWW  gW
Wg      gW
Wg   W WWW
Wg   W BgW
Wgk  WW gW
WgggHggggW
WWWWWWWWWW
