WWWW0WWWWW
W        W
W  S     W
WWWWW    W
W   W    W
W   W  WWW
W  h     W
W        W
W        W
WWWWWWWWWW
