#
# 0 D room2.txt 1
# 1 D room1.txt 2
# 2 D room4.txt 0
#
WWWWWWWWWW
0        1
Wg    WWWW
WWWWWR   W
Wm       W
WWWW   W W
Wg    PW W
WgPWWWWW W
WgaW     W
WWWW2WWWWW
