#
# 0 D room1.txt 2
# 1 D room2.txt 1 key
# 2 E room2.txt 1
#
WWWW2WWWWW
WS      gW
Wh   W   W
WWWm WWW W
Wgg  W S W
Wg WWW W W
Wgg  B W W
WWWW   W W
W      W 1
WWWW0WWWWW
