#
# 0 D room2.txt 1 key
#
WWWW0WWWWW
Wggg ggggW
WgB   m gW
WWWW W mgW
Wg h m  gW
Wgs kW WWW
Wg   W BgW
Wg   WW gW
WgggHggggW
WWWWWWWWWW
