#
# 0 D room1.txt 0
#
WWWW0WWWWW
Wggg ggggW
WgB     gW
WWWW W  gW
Wg      gW
Wg   W WWW
Wg   W BgW
Wg   WW gW
WgggHggggW
WWWWWWWWWW
