#
# 0 D room4.txt 1
# 1 D room6.txt 0 key5
#
WWWWWWWWWW
WS m   ghW
W tgWWWggW
W gWW    W
W WW     W
0 W      W
WWg  TpW W
WgSgWWWW W
WkgW S   W
WWWW1WWWWW