#
# 0 D room0.txt 1
# 1 E room2.txt 0
# 2 D room3.txt 1 Key1
#
WWWW1WWWWW
WR     ggW
Wm   W   W
WWW  WWW W
Wgg  W  RW
WgsWWW WkW
Wgg  B WRW
WtWW   W W
W      W 2
WWWW0WWWWW
