#
# 0 E room0.txt 0
# 1 D room1.txt 0 Key0
#
WWWW1WWWWW
Wggg ggggW
WgB     gW
WWWWWW  gW
Wg      gW
Wg   W WWW
Wg   W BgW
Wgk  WW gW
WgggHggggW
WWWW0WWWWW
