#
# 1 D room0.txt 0
# 0 D room3.txt 1
#
WWWWWWWWWW
WS  G    W
W  WW    W
W WW    sW
W W      W
W      W W
W      W W
W  WWWWW W
0  W     W
WWWW1WWWWW
