#
# 0 D room0.txt 0
# 1 D room0.txt 0
#
WWWWWWWWWW
W        W
W     WWWW
WWWWW   sW
W b      W
WWWW   W W
W     TW W
W  WWWWW W
0  W     W
WWWW1WWWWW
