#
# 0 D room1.txt 1
#
WWWW0WWWWW
W m     sW
W   h  T W
WWWWW  s W
W   W    W
W   W  WWW
W  H     W
W      B W
W        W
WWWWWWWWWW
